6 11
----------
|........|
|...|..@.|
|...--...|
|........|
----------